- TUDO ESTA CONECTADO

IA - dispositivos capazes de pensar sozinhos | avaliar dados e modificar processos | aprender e modificar o pr√≥prio codigo de acordo com os novos parametros

Rede - armazenamento e acesso a informacoes em servidores | conecta novos locais e acrescenta valor as maquinas em industria

Gateway - centro de conexao local para dispositivo smart de IOT

PAN (pessoal) - pequenos dispositivos sem fio (bluetooth)
LAN (local) - pequena area local em uma corporacao (computador, impressora..)
WAN (longa distancia) - conjunto de LAN
Wireless - onda eletromagnetica para transmissao de sinal sem fio (qualquer anterior)
Nuvem - servidores conectados online (armazenar e analisar dados)
Fog (neblina | pre-processados na borda) (IoT) - armazenar dados do sensor de forma segura e mais perto de onde possam ser analisar

rede baseada em intencao (IBN) - aprendizagem automatica e automacao automatica para redes de controle

- TUDO SE TORNA PROGRAMAVEL

Software de app - tarefa especifica
Software de virtualizacao - unico servidor fisico host de varias maquinas
Prototipagem - processo de criacao de modelo de um trabalho rudimentar
Arduino - plataforma de computacao fisica de codigo aberto montada em uma placa microcontroladora
Beaglebone - computador melhor para aplicativos que exige mais requisito de processamento

- TUDO GERA DADOS

Computacao em neblina - mais proximo da origem (borda)
Hadoop - software distribui e processa grandes conjuntos de dados em quantidades menores
BD distribuido - grande volume de dados divididos em partes menores armazenados em diferentes servidores
Mineiracao de dados - dados brutos em informacoes e relacionamento de grande conjunto de dados
Analise de dados - limpeza transformacaop e modelagem de dados para informacoes uteis

- TUDO PODE SER AUTOMATIZA
garantia - IBN verifica ponta a ponta
traducao - IBN intencao de negocio
ativacao - IBN provisiona dispositivo
Cisco DNA -  arquitetura IBN aberta

- TUDO PRECISA SER PROTEGIDO

MAC - permite dispositivos autorizados em rede sem fio
Seguranca fisica - Alarme, sistema UPS e HVAC
Hotpot - abre rede sem fio publica
WPA2 - algoritmo de criptografia sem fio
